39-51-51-40-22-16-16-15-10-14-11-11-17-16-16-20
41-51-37-48-11-16-15-10-10-10-10-17-16-20-21-11
47-39-42-46-14-15-10-10-10-10-10-14-11-11-11-11
13-33-39-42-43-46-10-10-10-10-10-10-10-10-10-10
11-10-47-38-38-48-10-10-10-10-10-10-10-10-10-10
15-12-11-11-11-13-10-10-10-10-10-10-10-10-10-10
13-22-16-16-16-16-13-12-11-13-10-10-10-10-10-10
16-16-16-16-16-16-16-11-16-11-13-10-10-10-10-10
16-16-16-21-16-16-20-15-11-15-10-10-45-43-43-43
14-16-16-16-16-15-14-11-11-13-10-10-47-39-51-51
16-16-16-16-16-16-16-16-17-11-10-10-10-47-38-38
16-16-16-16-16-16-16-20-11-15-10-10-10-10-10-10
