80-80-80-80-80-80-80-80-80-80-80-80-80-80-80-80-80-80-80-80-80-80-80-80-80-80-80-80-80-80-80-80-80-80-80-80-80-80-80-80-80-80-80-80-80-80-80-80-80-80-80-80-80-80-80-80-80-80-80-80-80-80-80-80
80-80-80-80-80-80-80-80-80-80-80-80-80-80-80-80-80-80-80-80-80-80-80-80-80-80-80-80-80-80-80-80-80-80-80-80-80-80-80-80-80-80-80-80-80-80-80-80-80-80-80-80-80-80-80-80-80-80-80-80-80-80-80-80
80-80-80-80-80-80-80-80-80-80-80-80-80-80-80-80-80-80-80-80-80-80-80-80-80-80-80-80-80-80-80-80-80-80-80-80-80-80-80-80-80-80-80-80-80-80-80-80-80-80-80-80-80-80-80-80-80-80-80-80-80-80-80-80
80-80-80-80-80-80-80-80-80-80-80-80-80-80-80-80-80-80-80-80-80-80-80-80-80-80-80-80-80-80-80-80-80-80-80-80-80-80-80-80-80-80-80-80-80-80-80-80-80-80-80-80-80-80-80-80-80-80-80-80-80-80-80-80
80-80-80-80-80-80-80-80-80-80-80-80-80-80-80-80-80-80-80-80-80-80-80-80-80-80-80-80-80-80-80-80-80-80-80-80-80-80-80-80-80-80-80-80-80-80-80-80-80-80-80-80-80-80-80-80-80-80-80-80-80-80-80-80
80-80-80-80-80-80-80-80-80-80-80-80-80-80-80-80-80-80-80-80-80-80-80-80-80-80-80-80-80-80-80-80-80-80-80-80-80-80-80-80-80-80-80-80-80-80-80-80-80-80-80-80-80-80-80-80-80-80-80-80-80-80-80-80
80-80-80-80-80-80-80-16-16-16-16-16-16-16-16-16-16-16-16-16-16-16-16-16-16-16-16-16-16-16-16-16-16-16-16-16-16-16-16-16-16-16-16-16-16-16-16-16-16-16-16-16-16-16-16-16-16-80-80-80-80-80-80-80
80-80-80-80-80-80-80-16-10-10-10-10-10-16-10-10-10-10-10-10-10-10-10-10-10-10-10-16-10-10-10-10-10-10-10-16-10-10-10-10-10-10-10-16-10-10-10-10-10-10-10-10-10-10-10-10-16-80-80-80-80-80-80-80
80-80-80-80-80-80-80-16-16-16-16-16-10-16-16-16-10-16-16-16-16-16-16-16-16-16-10-16-16-16-16-16-16-16-10-16-10-16-16-16-16-16-10-16-10-16-16-16-16-16-16-16-16-16-10-16-16-80-80-80-80-80-80-80
80-80-80-80-80-80-80-16-10-10-10-10-10-16-10-10-10-16-10-10-10-10-10-10-10-10-10-16-10-10-10-10-10-16-10-10-10-10-10-16-10-16-10-16-10-16-10-10-10-10-10-10-10-10-10-10-16-80-80-80-80-80-80-80
80-80-80-80-80-80-80-16-10-16-16-16-16-16-10-16-16-16-10-16-16-16-16-16-16-16-10-16-10-16-16-16-10-16-10-16-16-16-10-16-10-16-10-16-10-16-16-16-10-16-16-10-16-16-16-16-16-80-80-80-80-80-80-80
80-80-80-80-80-80-80-16-10-16-10-10-10-10-10-16-10-10-10-10-10-10-10-16-10-10-10-10-10-16-10-10-10-10-10-16-10-10-10-16-10-16-10-10-10-16-10-10-10-16-10-10-10-16-10-10-16-80-80-80-80-80-80-80
80-80-80-80-80-80-80-16-10-16-16-16-16-16-10-16-10-16-16-16-16-16-10-16-10-16-10-16-16-16-16-16-16-16-16-16-10-16-16-16-10-16-16-16-16-16-10-16-16-16-10-16-10-16-10-16-16-80-80-80-80-80-80-80
80-80-80-80-80-80-80-16-10-10-10-10-10-10-10-16-10-10-10-16-10-10-10-16-10-16-10-10-10-10-10-10-10-16-10-10-10-16-10-10-10-10-10-10-10-16-10-16-10-10-10-16-10-10-10-16-16-80-80-80-80-80-80-80
80-80-80-80-80-80-80-16-16-16-16-16-16-16-16-16-16-16-10-16-10-16-16-16-10-16-16-16-16-16-10-16-16-16-10-16-16-16-10-16-16-16-10-16-10-16-10-16-10-16-16-16-16-16-10-10-16-80-80-80-80-80-80-80
80-80-80-80-80-80-80-16-10-10-10-16-10-10-10-10-10-10-10-16-10-16-10-10-10-16-10-10-10-16-10-10-10-16-10-10-10-16-10-10-10-16-10-16-10-10-10-16-10-16-10-10-10-10-10-10-16-80-80-80-80-80-80-80
80-80-80-80-80-80-80-16-10-16-10-16-10-16-16-16-10-16-10-16-10-16-10-16-16-16-10-16-10-16-16-16-10-16-16-16-10-16-16-16-16-16-10-16-16-16-10-16-10-16-16-16-10-16-16-16-16-80-80-80-80-80-80-80
80-80-80-80-80-80-80-16-10-16-10-16-10-16-10-10-10-16-10-16-10-16-10-10-10-16-10-16-10-10-10-16-10-10-10-16-10-10-10-16-10-10-10-16-10-10-10-16-10-10-10-16-10-16-10-10-16-80-80-80-80-80-80-80
80-80-80-80-80-80-80-16-10-16-10-16-10-16-10-16-16-16-10-16-10-16-16-16-10-10-10-16-16-16-10-16-16-16-10-16-16-16-10-16-10-16-16-16-10-16-16-16-16-16-10-16-10-16-10-16-16-80-80-80-80-80-80-80
80-80-80-80-80-80-80-16-10-16-10-10-10-16-10-10-10-16-10-16-10-16-10-16-10-16-10-16-10-10-10-16-10-10-10-16-10-16-10-16-10-16-10-16-10-10-10-16-10-10-10-16-10-10-10-10-16-80-80-80-80-80-80-80
80-80-80-80-80-80-80-16-10-16-16-16-10-16-16-16-10-16-16-16-10-16-10-16-10-16-10-16-16-16-10-16-10-16-10-16-10-16-10-16-10-16-10-16-16-16-10-16-10-16-10-16-16-16-10-16-16-80-80-80-80-80-80-80
80-80-80-80-80-80-80-16-10-10-10-16-10-10-10-16-10-10-10-10-10-16-10-16-10-16-10-10-10-16-10-16-10-16-10-16-10-16-10-10-10-16-10-16-10-10-10-16-10-16-10-16-10-10-10-10-16-80-80-80-80-80-80-80
80-80-80-80-80-80-80-16-16-16-10-16-16-16-10-16-16-16-16-16-16-16-10-16-10-16-16-16-10-16-10-16-10-16-10-16-10-16-16-16-16-16-10-16-10-16-16-16-10-16-16-16-10-16-10-10-16-80-80-80-80-80-80-80
80-80-80-80-80-80-80-16-10-10-10-16-10-10-10-16-10-10-10-10-10-16-10-10-10-16-10-10-10-16-10-16-10-16-10-10-10-16-10-10-10-10-10-10-10-16-10-10-10-16-10-10-10-16-10-10-16-80-80-80-80-80-80-80
80-80-80-80-80-80-80-16-10-16-16-16-10-16-16-16-10-16-16-16-16-16-10-16-16-16-10-16-16-16-10-16-10-16-16-16-16-16-10-16-10-16-16-16-16-16-10-16-16-16-10-16-16-16-16-16-16-80-80-80-80-80-80-80
80-80-80-80-80-80-80-16-10-10-10-10-10-16-10-10-10-16-10-10-10-16-10-16-10-10-10-16-10-10-10-16-10-16-10-10-10-10-10-16-10-16-10-10-10-10-10-16-10-10-10-16-10-10-10-10-16-80-80-80-80-80-80-80
80-80-80-80-80-80-80-16-10-16-10-16-16-16-10-16-16-16-10-16-10-16-10-16-16-16-10-16-10-16-16-16-10-16-10-16-16-16-16-16-10-16-10-16-16-16-16-16-10-16-16-16-10-16-10-10-16-80-80-80-80-80-80-80
80-80-80-80-80-80-80-16-10-16-16-16-10-10-10-16-10-10-10-16-10-10-10-10-10-10-10-16-10-10-10-16-10-16-10-16-10-10-10-10-10-16-10-10-10-10-10-10-10-10-10-10-10-16-10-10-16-80-80-80-80-80-80-80
80-80-80-80-80-80-80-16-10-16-10-10-10-16-10-16-10-16-10-16-16-16-10-16-16-16-16-16-16-16-16-16-10-16-10-16-16-16-16-16-10-16-16-16-16-16-16-16-16-10-16-16-16-16-10-16-16-80-80-80-80-80-80-80
80-80-80-80-80-80-80-16-10-10-10-16-10-16-10-16-10-16-10-10-10-10-10-10-10-10-10-16-10-10-10-10-10-16-10-16-10-10-10-16-10-10-10-16-10-10-10-16-10-10-10-10-16-10-10-10-16-80-80-80-80-80-80-80
80-80-80-80-80-80-80-16-10-16-10-16-10-16-10-10-10-16-10-21-10-22-10-21-10-22-10-16-10-16-10-16-10-16-10-16-10-16-10-16-10-21-10-10-10-22-10-16-10-21-22-10-16-10-10-10-16-80-80-80-80-80-80-80
80-80-80-80-80-80-80-16-16-16-16-16-16-16-16-16-16-16-16-16-16-16-16-16-16-16-16-16-16-16-16-16-16-16-16-16-16-16-16-16-16-16-16-16-16-16-16-16-16-16-16-16-16-16-16-16-16-80-80-80-80-80-80-80
80-80-80-80-80-80-80-80-80-80-80-80-80-80-80-80-80-80-80-80-80-80-80-80-80-80-80-80-80-80-80-80-80-80-80-80-80-80-80-80-80-80-80-80-80-80-80-80-80-80-80-80-80-80-80-80-80-80-80-80-80-80-80-80
80-80-80-80-80-80-80-80-80-80-80-80-80-80-80-80-80-80-80-80-80-80-80-80-80-80-80-80-80-80-80-80-80-80-80-80-80-80-80-80-80-80-80-80-80-80-80-80-80-80-80-80-80-80-80-80-80-80-80-80-80-80-80-80
80-80-80-80-80-80-80-80-80-80-80-80-80-80-80-80-80-80-80-80-80-80-80-80-80-80-80-80-80-80-80-80-80-80-80-80-80-80-80-80-80-80-80-80-80-80-80-80-80-80-80-80-80-80-80-80-80-80-80-80-80-80-80-80
80-80-80-80-80-80-80-80-80-80-80-80-80-80-80-80-80-80-80-80-80-80-80-80-80-80-80-80-80-80-80-80-80-80-80-80-80-80-80-80-80-80-80-80-80-80-80-80-80-80-80-80-80-80-80-80-80-80-80-80-80-80-80-80
80-80-80-80-80-80-80-80-80-80-80-80-80-80-80-80-80-80-80-80-80-80-80-80-80-80-80-80-80-80-80-80-80-80-80-80-80-80-80-80-80-80-80-80-80-80-80-80-80-80-80-80-80-80-80-80-80-80-80-80-80-80-80-80
80-80-80-80-80-80-80-80-80-80-80-80-80-80-80-80-80-80-80-80-80-80-80-80-80-80-80-80-80-80-80-80-80-80-80-80-80-80-80-80-80-80-80-80-80-80-80-80-80-80-80-80-80-80-80-80-80-80-80-80-80-80-80-80